########################################
#                                      #
#                                      #
#                                      #
#                                      #
#                                      #
#                                      #
#                    ###               #
#                                      #
#                                      #
#                                      #
#                                      #
#                                      #
#     ##########                       #
#                                      #
#                                      #
#                      ########        #
#                                      #
#                                      #
#                                ###   #
#                                ###   #
########################################
########################################
